###################
#........!.!......#
#...............!.#
#.!...............#
#...###########...#
#...#.@.......#...#
#...#.........#...#
#...#.........#...#
#...#....x....#...#
#!..#.......!.#...#
#...#.........#..!#
#...#.........#...#
#...#####.#####...#
#.................#
#......!.....!....#
#.!..............!#
###################